example;10;10;0;4;
g ;g ;g ;g ;g ;g ;g ;g ;g ;g ;
g ;g ;pE;pE;pE;pE;pE;pE;pS;g ;
g ;g ;pN;g ;w ;w ;w ;g ;pS;g ;
g ;g ;pN;g ;w ;w ;w ;g ;pS;g ;
pE;pE;pN;g ;pS;pW;pW;g ;pS;g ;
g ;g ;w ;w ;pS;g ;pN;g ;pS;g ;
g ;pS;pW;pW;pW;g ;pN;w ;pS;w ;
g ;pS;w ;w ;g ;g ;pN;w ;pS;w ;
g ;pS;w ;w ;g ;g ;pN;pW;pW;w ;
g ;pS;g ;g ;g ;g ;g ;w ;w ;w ;