teromap;10;10;1;9;
g ;g ;g ;g ;g ;g ;g ;pN;g ;g ;
g ;g ;g ;pE;pE;pE;pE;pN;g ;g ;
g ;g ;g ;pN;g ;w ;g ;w ;g ;g ;
g ;g ;pE;pN;w ;w ;w ;w ;g ;g ;
g ;g ;pN;g ;pS;pW;pW;pW;g ;w ;
g ;g ;pN;pW;pW;g ;g ;pN;g ;w ;
g ;g ;g ;g ;g ;g ;g ;pN;g ;w ;
g ;pE;pE;pE;pS;g ;g ;pN;g ;g ;
g ;pN;g ;g ;pE;pE;pE;pN;g ;g ;
g ;pN;g ;g ;g ;g ;g ;g ;g ;g ;